11111111
1XXXXXX1
11110111
10000001
10000001
100E0001
10000001
10000001
10P00111
11111111