11111111
1XXXXXX1
11110111
10000001
1000CC01
10P000E1
11110111