11111111
1XXXXXX1
11110111
1CCC0001
10000001
10000001
10P000E1
11111111