11111111
1XXXXXX1
11110111
1CCC0001
10000001
10000001
10000001
100000P1
11111111