1111111111111111
1XXXXXXXXXXXXXX1
1XXXXXXXXXXXXXX1
1XXXXXXXXXXXXXX1
1000000000000001
1101101101110111
100CCCCCCCCC0001
1000000000000001
1000000000000001
1000000000P000E1
1111111111111111