11111111
1P0C0001
100000C1
10000001
10101011
10101011
10101011
10111011
10101011
10101011
100000E1
11111111