1111111111111111
1P0100000000X001
1000000000000001
1001000000000001
10101010C00E0001
1010101000000001
1C10101000000001
1011101000000001
1010101000000001
1010100000X00C01
1C000C1000000001
1111111111111111