11111111111111111111
1000CCC11111X00000X1
100000000000P0000001
10000000000000000001
10100010000000000001
10100010000000000001
10001010000000000001
10111010000000000001
10101010000000000001
1010100000C00C000001
1C000C100000000000E1
11111111111111111111